10 10 
0 0
73 73 73 73 73 73 73 73 73 73
73 73 73 73 73 73 73 73 73 73
73 73 73 73 73 73 73 73 73 73
73 73 73 73 73 73 73 73 73 73
73 73 73 73 73 73 73 73 73 73
73 73 73 73 73 73 73 73 73 73
73 73 73 73 73 73 73 73 73 73
73 73 73 577 73 73 73 73 73 73
73 73 73 577 577 577 577 577 577 577
73 73 73 73 73 73 73 73 73 73
1064 1064 1064 1064 1064 1064 1064 1064 1064 1064
1064 0 1671 0 1155 0 0 0 0 1064
1064 0 0 0 0 0 1704 0 0 1064
1064 0 787 788 787 788 0 1351 1352 1064
1064 0 819 820 819 820 0 1383 1384 1064
1064 0 851 852 851 852 0 0 1671 1064
1064 0 883 884 883 884 0 1704 0 1064
1064 0 0 0 994 0 0 0 1643 1064
1064 0 1643 0 0 0 0 0 0 1064
1064 1064 1064 1064 1064 1064 1064 1064 1064 1064
0 0 0 0 0 0 0 0 0 0
0 0 0 0 0 0 0 0 0 0
0 0 0 0 0 0 0 0 0 0
0 0 0 0 0 961 0 0 0 0
0 0 0 0 0 0 0 0 0 0
0 0 0 711 0 899 0 0 0 0
0 0 0 968 0 931 0 0 0 0
0 0 0 0 0 0 0 0 0 0
0 0 0 0 0 0 0 0 0 0
0 0 0 0 0 0 0 0 0 0